1 13 31
###############################
#    a    *  1 * 2 *  * * *   #
# #     # # #*#*#     #*#*#*# #
#  x*b    ***  *  1   * 2 * * #
# #                     # # #*#
#f     p   x **  *  *   1     #
# # #c#                     # #
#*  *  d   *  *      *        #
# #      #*# # # #*#*# #    # #
#* e  **  *       *           #
# #*# #       # #*# #     #   #
#s          *   *  *          #
###############################