1 12 18
##################
#p * *x *s1** b* #
# #*# #b# # # #*##
#***b** * f 1 ** #
# # # #*# # # #f##
#* f*1  **a*  * *#
# # #*# #*# #c#2##
# *2* d** e*  ** #
#*#*#*# # # #3#*##
#*** * ** *****  #
#*#*# # # # #*#*##
##################
