1 6 18
##################
#p ** x*   *1 s* #
# # #*#*# # #*# ##
#b      *1 *** * #
#*#b#*# # # #*# ##
##################
