1 26 10
##########
#p **** *#
# #x# #*##
#*1* s *b#
#1#*#*#*##
#*   b*  #
#*#b# # ##
#  * 1* *#
#*# # #*##
#2 f** * #
#f# #*# ##
#**f*2** #
# #*#*# ##
#    3a* #
#*#*#c#*##
#   * * *#
# #*# #d##
#  4***e*#
#*# #*#*##
# *x * * #
# # #*# ##
#  * s * #
#*# #*# ##
# * *    #
# # # # ##
##########
